1 5 5 1 1 1 1 1 1 1 1 1 1 1 1 1 1 5 5 1 1 1 1 1 1 1 1 1 1 1 1 1 1 5 5 1 1 1 1 1 1 1 1 1 1 1 1 1 2 2
1 5 5 5 0 0 0 4 0 0 0 0 0 0 0 1 1 5 5 1 1 1 1 1 1 1 1 1 1 1 1 1 1 5 5 1 1 1 1 1 1 1 1 1 1 1 1 1 2 2
1 0 5 5 0 0 0 0 0 0 0 0 0 0 0 1 1 5 5 1 1 1 1 1 1 1 1 1 1 1 1 1 1 5 5 1 1 1 1 1 1 1 1 1 1 1 1 1 2 2
1 0 5 5 5 0 0 0 0 0 0 0 4 0 0 1 1 5 5 1 1 1 1 1 1 1 1 1 1 1 1 1 1 5 5 1 1 1 1 1 1 1 1 1 1 1 1 1 2 2
1 0 0 5 5 0 0 0 0 0 0 0 0 0 0 1 1 5 5 1 1 1 1 1 1 1 1 1 1 1 1 1 1 5 5 1 1 1 1 1 1 1 1 1 1 1 1 1 2 2
1 0 0 5 5 0 0 0 0 0 0 0 0 0 0 1 1 5 5 1 1 1 1 1 1 1 1 1 1 1 1 1 1 5 5 1 1 1 1 1 1 1 1 1 1 1 1 1 2 2
1 0 0 0 5 3 3 3 3 3 4 0 0 0 0 1 1 5 5 1 1 1 1 1 1 1 1 1 1 1 1 1 1 5 5 1 1 1 1 1 1 1 1 1 1 1 1 1 2 2
1 0 0 0 0 3 2 2 2 2 3 0 0 0 0 1 1 5 5 1 1 1 1 1 1 1 1 1 1 1 1 1 1 5 5 1 1 1 1 1 1 1 1 1 1 1 1 1 2 2
1 0 0 0 0 3 2 2 2 2 2 3 0 0 0 1 1 5 5 1 1 1 1 1 1 1 1 1 1 1 1 1 1 5 5 1 1 1 1 1 1 1 1 1 1 1 1 1 2 2
1 0 0 0 0 3 2 2 2 2 2 3 0 0 0 1 1 5 5 1 1 1 1 1 1 1 1 1 1 1 1 1 1 5 5 1 1 1 1 1 1 1 1 1 1 1 1 1 2 2
1 4 4 4 4 3 2 2 2 2 2 3 4 4 4 1 1 5 5 1 1 1 1 1 1 1 1 1 1 1 1 1 1 5 5 1 1 1 1 1 1 1 1 1 1 1 1 1 2 2
1 1 1 1 1 1 1 1 1 1 1 1 1 1 1 1 1 5 5 1 1 1 1 1 1 1 1 1 1 1 1 1 1 5 5 1 1 1 1 1 1 1 1 1 1 1 1 1 2 2
1 5 5 1 1 1 1 1 1 1 1 1 1 1 1 1 1 5 5 1 1 1 1 1 1 1 1 1 1 1 1 1 1 5 5 1 1 1 1 1 1 1 1 1 1 1 1 1 2 2
1 5 5 5 0 0 0 4 0 0 0 0 0 0 0 1 1 5 5 1 1 1 1 1 1 1 1 1 1 1 1 1 1 5 5 1 1 1 1 1 1 1 1 1 1 1 1 1 2 2
1 0 5 5 0 0 0 0 0 0 0 0 0 0 0 1 1 5 5 1 1 1 1 1 1 1 1 1 1 1 1 1 1 5 5 1 1 1 1 1 1 1 1 1 1 1 1 1 2 2
1 0 5 5 5 0 0 0 0 0 0 0 4 0 0 1 1 5 5 1 1 1 1 1 1 1 1 1 1 1 1 1 1 5 5 1 1 1 1 1 1 1 1 1 1 1 1 1 2 2
1 0 0 5 5 0 0 0 0 0 0 0 0 0 0 1 1 5 5 1 1 1 1 1 1 1 1 1 1 1 1 1 1 5 5 1 1 1 1 1 1 1 1 1 1 1 1 1 2 2
1 0 0 5 5 0 0 0 0 0 0 0 0 0 0 1 1 5 5 1 1 1 1 1 1 1 1 1 1 1 1 1 1 5 5 1 1 1 1 1 1 1 1 1 1 1 1 1 2 2
1 0 0 0 5 3 3 3 3 3 4 0 0 0 0 1 1 5 5 1 1 1 1 1 1 1 1 1 1 1 1 1 1 5 5 1 1 1 1 1 1 1 1 1 1 1 1 1 2 2
1 0 0 0 0 3 2 2 2 2 3 0 0 0 0 1 1 5 5 1 1 1 1 1 1 1 1 1 1 1 1 1 1 5 5 1 1 1 1 1 1 1 1 1 1 1 1 1 2 2
1 0 0 0 0 3 2 2 2 2 2 3 0 0 0 1 1 5 5 1 1 1 1 1 1 1 1 1 1 1 1 1 1 5 5 1 1 1 1 1 1 1 1 1 1 1 1 1 2 2
1 0 0 0 0 3 2 2 2 2 2 3 0 0 0 1 1 5 5 1 1 1 1 1 1 1 1 1 1 1 1 1 1 5 5 1 1 1 1 1 1 1 1 1 1 1 1 1 2 2
1 4 4 4 4 3 2 2 2 2 2 3 4 4 4 1 1 5 5 1 1 1 1 1 1 1 1 1 1 1 1 1 1 5 5 1 1 1 1 1 1 1 1 1 1 1 1 1 2 2
1 1 1 1 1 1 1 1 1 1 1 1 1 1 1 1 1 5 5 1 1 1 1 1 1 1 1 1 1 1 1 1 1 5 5 1 1 1 1 1 1 1 1 1 1 1 1 1 2 2
1 5 5 1 1 1 1 1 1 1 1 1 1 1 1 1 1 5 5 1 1 1 1 1 1 1 1 1 1 1 1 1 1 5 5 1 1 1 1 1 1 1 1 1 1 1 1 1 2 2
1 5 5 5 0 0 0 4 0 0 0 0 0 0 0 1 1 5 5 1 1 1 1 1 1 1 1 1 1 1 1 1 1 5 5 1 1 1 1 1 1 1 1 1 1 1 1 1 2 2
1 0 5 5 0 0 0 0 0 0 0 0 0 0 0 1 1 5 5 1 1 1 1 1 1 1 1 1 1 1 1 1 1 5 5 1 1 1 1 1 1 1 1 1 1 1 1 1 2 2
1 0 5 5 5 0 0 0 0 0 0 0 4 0 0 1 1 5 5 1 1 1 1 1 1 1 1 1 1 1 1 1 1 5 5 1 1 1 1 1 1 1 1 1 1 1 1 1 2 2
1 0 0 5 5 0 0 0 0 0 0 0 0 0 0 1 1 5 5 1 1 1 1 1 1 1 1 1 1 1 1 1 1 5 5 1 1 1 1 1 1 1 1 1 1 1 1 1 2 2
1 0 0 5 5 0 0 0 0 0 0 0 0 0 0 1 1 5 5 1 1 1 1 1 1 1 1 1 1 1 1 1 1 5 5 1 1 1 1 1 1 1 1 1 1 1 1 1 2 2
1 0 0 0 5 3 3 3 3 3 4 0 0 0 0 1 1 5 5 1 1 1 1 1 1 1 1 1 1 1 1 1 1 5 5 1 1 1 1 1 1 1 1 1 1 1 1 1 2 2
1 0 0 0 0 3 2 2 2 2 3 0 0 0 0 1 1 5 5 1 1 1 1 1 1 1 1 1 1 1 1 1 1 5 5 1 1 1 1 1 1 1 1 1 1 1 1 1 2 2
1 0 0 0 0 3 2 2 2 2 2 3 0 0 0 1 1 5 5 1 1 1 1 1 1 1 1 1 1 1 1 1 1 5 5 1 1 1 1 1 1 1 1 1 1 1 1 1 2 2
1 0 0 0 0 3 2 2 2 2 2 3 0 0 0 1 1 5 5 1 1 1 1 1 1 1 1 1 1 1 1 1 1 5 5 1 1 1 1 1 1 1 1 1 1 1 1 1 2 2
1 4 4 4 4 3 2 2 2 2 2 3 4 4 4 1 1 5 5 1 1 1 1 1 1 1 1 1 1 1 1 1 1 5 5 1 1 1 1 1 1 1 1 1 1 1 1 1 2 2
1 1 1 1 1 1 1 1 1 1 1 1 1 1 1 1 1 5 5 1 1 1 1 1 1 1 1 1 1 1 1 1 1 5 5 1 1 1 1 1 1 1 1 1 1 1 1 1 2 2
1 5 5 1 1 1 1 1 1 1 1 1 1 1 1 1 1 5 5 1 1 1 1 1 1 1 1 1 1 1 1 1 1 5 5 1 1 1 1 1 1 1 1 1 1 1 1 1 2 2
1 5 5 5 0 0 0 4 0 0 0 0 0 0 0 1 1 5 5 1 1 1 1 1 1 1 1 1 1 1 1 1 1 5 5 1 1 1 1 1 1 1 1 1 1 1 1 1 2 2
1 0 5 5 0 0 0 0 0 0 0 0 0 0 0 1 1 5 5 1 1 1 1 1 1 1 1 1 1 1 1 1 1 5 5 1 1 1 1 1 1 1 1 1 1 1 1 1 2 2
1 0 5 5 5 0 0 0 0 0 0 0 4 0 0 1 1 5 5 1 1 1 1 1 1 1 1 1 1 1 1 1 1 5 5 1 1 1 1 1 1 1 1 1 1 1 1 1 2 2
1 0 0 5 5 0 0 0 0 0 0 0 0 0 0 1 1 5 5 1 1 1 1 1 1 1 1 1 1 1 1 1 1 5 5 1 1 1 1 1 1 1 1 1 1 1 1 1 2 2
1 0 0 5 5 0 0 0 0 0 0 0 0 0 0 1 1 5 5 1 1 1 1 1 1 1 1 1 1 1 1 1 1 5 5 1 1 1 1 1 1 1 1 1 1 1 1 1 2 2
1 0 0 0 5 3 3 3 3 3 4 0 0 0 0 1 1 5 5 1 1 1 1 1 1 1 1 1 1 1 1 1 1 5 5 1 1 1 1 1 1 1 1 1 1 1 1 1 2 2
1 0 0 0 0 3 2 2 2 2 3 0 0 0 0 1 1 5 5 1 1 1 1 1 1 1 1 1 1 1 1 1 1 5 5 1 1 1 1 1 1 1 1 1 1 1 1 1 2 2
1 0 0 0 0 3 2 2 2 2 2 3 0 0 0 1 1 5 5 1 1 1 1 1 1 1 1 1 1 1 1 1 1 5 5 1 1 1 1 1 1 1 1 1 1 1 1 1 2 2
1 0 0 0 0 3 2 2 2 2 2 3 0 0 0 1 1 5 5 1 1 1 1 1 1 1 1 1 1 1 1 1 1 5 5 1 1 1 1 1 1 1 1 1 1 1 1 1 2 2
1 4 4 4 4 3 2 2 2 2 2 3 4 4 4 1 1 5 5 1 1 1 1 1 1 1 1 1 1 1 1 1 1 5 5 1 1 1 1 1 1 1 1 1 1 1 1 1 2 2
1 1 1 1 1 1 1 1 1 1 1 1 1 1 1 1 1 5 5 1 1 1 1 1 1 1 1 1 1 1 1 1 1 5 5 1 1 1 1 1 1 1 1 1 1 1 1 1 2 2
1 4 4 4 4 3 2 2 2 2 2 3 4 4 4 1 1 5 5 1 1 1 1 1 1 1 1 1 1 1 1 1 1 5 5 1 1 1 1 1 1 1 1 1 1 1 1 1 2 2
1 1 1 1 1 1 1 1 1 1 1 1 1 1 1 1 1 5 5 1 1 1 1 1 1 1 1 1 1 1 1 1 1 5 5 1 1 1 1 1 1 1 1 1 1 1 1 1 2 2

